[
  {
    "name": "Level1",
    "map": [
      "11100000000000000111",
      "10000000000000000001",
      "10000000000000000001",
      "00000000000000000000",
      "00000000000000000000",
      "00000000000000000000",
      "00000000000000000000",
      "00000000000000000000",
      "00000011111111100000",
      "00000000000000000000",
      "00000000000000000000",
      "00000000000000000000",
      "00000011111111100000",
      "00000000000000000000",
      "00000000000000000000",
      "00000000000000000000",
      "00000000000000000000",
      "10000000000000000001",
      "10000000000000000001",
      "11100000000000000111"
    ]
  },
  {
    "name": "Level2",
    "map": [
      "11100000000000000111",
      "10000000000000000001",
      "10000000000000000001",
      "00000000000000000000",
      "00000000000000000000",
      "00000000000000000000",
      "00000000000000000000",
      "00000000000000000000",
      "00000000000000000000",
      "00000000000000000000",
      "00000000000000000000",
      "00000000000000000000",
      "00000000000000000000",
      "00000000000000000000",
      "00000000000000000000",
      "00000000000000000000",
      "00000000000000000000",
      "10000000000000000001",
      "10000000000000000001",
      "11100000000000000111"
    ]
  },
  {
    "name": "Level3",
    "map": [
      "11111111111111111111",
      "00000000000000000000",
      "00010000000000001000",
      "00111000000000011100",
      "00010000000000001000",
      "00000000000000000000",
      "00000000000000000000",
      "00000000000000000000",
      "00000000000000000000",
      "00000000000000000000",
      "00000000000000000000",
      "00000000000000000000",
      "00000000000000000000",
      "00000000000000000000",
      "00000000000000000000",
      "00010000000000001000",
      "00111000000000011100",
      "00010000000000001000",
      "00000000000000000000",
      "11111111111111111111"
    ]
  },
  {
    "name": "Level4",
    "map": [
      "11111111111111111111",
      "00000000000000000000",
      "00010000000000001000",
      "00111000000000011100",
      "00010000000000001000",
      "00000000000000000000",
      "00000000000000000000",
      "00000000000000000000",
      "00000000000000000000",
      "00000000000000000000",
      "00000000000000000000",
      "00000000000000000000",
      "00000000000000000000",
      "00000000000000000000",
      "00000000000000000000",
      "00010000000000001000",
      "00111000000000011100",
      "00010000000000001000",
      "00000000000000000000",
      "11111111111111111111"
    ]
  }
]