[
  {
    "name": "Level1",
    "map": [
      "11100000000000000111",
      "10000000000000000001",
      "10000000000000000001",
      "00000000000000000000",
      "00000000000000000000",
      "00000000000000000000",
      "00000000000000000000",
      "00000000000000000000",
      "00000011111111100000",
      "00000000000000000000",
      "00000000000000000000",
      "00000000000000000000",
      "00000011111111100000",
      "00000000000000000000",
      "00000000000000000000",
      "00000000000000000000",
      "00000000000000000000",
      "10000000000000000001",
      "10000000000000000001",
      "11100000000000000111"
    ]
  },
  {
    "name": "Level2",
    "map": [
      "11100000000000000111",
      "10000000000000000001",
      "10000000000000000001",
      "00000000000000000000",
      "00000000000000000000",
      "00000000000000000000",
      "00000000000000000000",
      "00000000000000000000",
      "00000000000000000000",
      "00000000000000000000",
      "00000000000000000000",
      "00000000000000000000",
      "00000000000000000000",
      "00000000000000000000",
      "00000000000000000000",
      "00000000000000000000",
      "00000000000000000000",
      "10000000000000000001",
      "10000000000000000001",
      "11100000000000000111"
    ]
  },
  {
    "name": "Level3",
    "map": [
      "11111111111111111111",
      "00000000000000000000",
      "00010000000000001000",
      "00111000000000011100",
      "00010000000000001000",
      "00000000000000000000",
      "00000000000000000000",
      "00000000000000000000",
      "00000000000000000000",
      "00000000000000000000",
      "00000000000000000000",
      "00000000000000000000",
      "00000000000000000000",
      "00000000000000000000",
      "00000000000000000000",
      "00010000000000001000",
      "00111000000000011100",
      "00010000000000001000",
      "00000000000000000000",
      "11111111111111111111"
    ]
  },
  {
    "name": "hello",
    "map": [
      "01210000000000000000",
      "01110000000000000000",
      "01210000000000000000",
      "00001110000000000000",
      "00001220000000000000",
      "00001110000000000000",
      "00001220000000000000",
      "00001110000000000000",
      "00000001000000000000",
      "00000001000000000000",
      "00000001000000000000",
      "00000001110000000000",
      "00000000001000000000",
      "00000000001000000000",
      "00000000001000000000",
      "00000000001110000000",
      "00000000000001110000",
      "00000000000001210000",
      "00000000000001210000",
      "00000000000001110000"
    ]
  }
]