[
  {
    "name": "Level1",
    "map": [
      "11100000000000000111",
      "10000000000000000001",
      "10000000000000000001",
      "00000000000000000000",
      "00000000000000000000",
      "00000000000000000000",
      "00000000000000000000",
      "00000000000000000000",
      "00000011111111100000",
      "00000000000000000000",
      "00000000000000000000",
      "00000000000000000000",
      "00000011111111100000",
      "00000000000000000000",
      "00000000000000000000",
      "00000000000000000000",
      "00000000000000000000",
      "10000000000000000001",
      "10000000000000000001",
      "11100000000000000111"
    ]
  },
  {
    "name": "Level2",
    "map": [
      "11100000000000000111",
      "10000000000000000001",
      "10000000000000000001",
      "00000000000000000000",
      "00000000000000000000",
      "00000000000000000000",
      "00000000000000000000",
      "00000000000000000000",
      "00000000000000000000",
      "00000000000000000000",
      "00000000000000000000",
      "00000000000000000000",
      "00000000000000000000",
      "00000000000000000000",
      "00000000000000000000",
      "00000000000000000000",
      "00000000000000000000",
      "10000000000000000001",
      "10000000000000000001",
      "11100000000000000111"
    ]
  },
  {
    "name": "Level3",
    "map": [
      "11111111111111111111",
      "00000000000000000000",
      "00010000000000001000",
      "00111000000000011100",
      "00010000000000001000",
      "00000000000000000000",
      "00000000000000000000",
      "00000000000000000000",
      "00000000000000000000",
      "00000000000000000000",
      "00000000000000000000",
      "00000000000000000000",
      "00000000000000000000",
      "00000000000000000000",
      "00000000000000000000",
      "00010000000000001000",
      "00111000000000011100",
      "00010000000000001000",
      "00000000000000000000",
      "11111111111111111111"
    ]
  },
  {
    "name": "TestName",
    "map": [
      "00000000000000000000",
      "00000000000000000000",
      "00000000000000000000",
      "00000000000000000000",
      "00000000000000000000",
      "00000000000000000000",
      "00000000000000000000",
      "00000100000000000000",
      "00001110000000000000",
      "00000100000000000000",
      "00000000000000000000",
      "00000000000000000000",
      "00000000000000000000",
      "00000000000000000000",
      "00000000000000000000",
      "00000000000000000000",
      "00000000000000000000",
      "00000000000000000001",
      "00000000000000000001",
      "00000000000000000011"
    ]
  },
  {
    "name": "2",
    "map": [
      "00000000000000000000",
      "00000000000000000000",
      "00000000000000000000",
      "00000000000000000000",
      "00000000000000000000",
      "00000000000000000010",
      "00000000000000000011",
      "00000000000000000000",
      "00000000000000000000",
      "00000000000000000000",
      "00000000000000000000",
      "00000000000000000000",
      "00000000000000000000",
      "00000000000000000000",
      "00000000000000000000",
      "00000000000000000000",
      "00000000000000000000",
      "00000000000000000000",
      "00000000000000000000",
      "00000000000000000000"
    ]
  },
  {
    "name": "hello",
    "map": [
      "00000000000000000000",
      "00000000000000101000",
      "00000000000000000001",
      "00000000000000000001",
      "00000000000000000001",
      "00100000000000000000",
      "00100000000000000001",
      "00000000000000000000",
      "01000000000001000000",
      "00000000000001100001",
      "00000000000000000000",
      "00000000000000000001",
      "00000000000000000010",
      "00000000000000000010",
      "00000000000000000010",
      "00000000000000000000",
      "00011100000000000010",
      "00000000000000000000",
      "00000000000100000000",
      "00000000000000000100"
    ]
  }
]